#artist - #title
breaka - sub hugs
fels - silver lining
swimful - atlantis (iceboy violet remix)
dj polo - burndown
dj lag, lanokies - bass & drum
dj maphorisa, xduppy - ngibolekeni
breaka - cascara
karnage - arcane proxy
free flow flava - papercut
pepe - grane drum 
gafacci - hysteria
doctor jeep - pula perereka
tmsv - dimensional
felly fell - burnout
debba - come around
aya - lip flip
lofty - joyless
lutsu - sweetest dreams
rotate - cash swing
coido - gasoline
liot - straig1
dismantle - junk
interplanetary criminal, riko dan - gunman
endrew - redemption dream
bianca oblivion ft sam binga - hypno 
bianca oblivion ft lunice & lamsi - scat track
dj rashad - in da club before 11 oclock (uk edit)
moreofus - blame
holographic - sonder
farrah - breakmyheart
shima - karma
teqmun - slug no escargot (ma sha remix)
ahadadream & nikki nair - red my mind
