#artist - #track
echo and the bunnymen - the killing moon
the cocteau twins - feathers-oar-blades
ghoest - the majestic end (part iv)
fogweaver - beyond the wall
heilung - galgaldr
chelea wolf - reins
fief - in the glass of the wizard
ritual howls - final service
trouble - snake eyes
sons of perdition - blood in the valley
bambara - elina's dream 
plough - chiaroscuro
anna von hausswolff - the mysterious vanishing of electra
lowlands - the fall
tricky - hell is round the corner
portishead - sour times
glass beams - mahal
aerial love feed - raise up
health - mean
curve - horror head
slowdive - alison
anilore - motion in maze
coatie pop - siiiccck serande
sevdaliza - rhode
swirlies - house of pancake
bauhaus - dark entries
love and rockets - haunted when the minutes drag
christian death - cavity - first communion
virgin in veil - heathrobs
xmal deutschland - incubus succubus 
witches rune - twilight
joy division - transmission
body maintenance - death's hall
shadowhouse - fall down
gvllow - love letters
homefront - real eyes
twin tribes - portal to the void
drab majesty - ellipsis
molchat doma - toska
molly nilsson - i hope you die
liliput - die matrosen
gang of four - damaged goods
siouxsie & the banshees
au pairs - it's obvious
night in athens - nightshades
forever grey - cold hand
lebanon hanover - gallowdance 
ortrotasce - distant in time
grauzone - eisbar
clan of xymox - jasmine and rose 
the sisters of mergy - lucretia my reflection
boy harsher - fate 
mareux - the perfect girl
dlina volny - follow me
curses - another heaven
oberst panizza - keine liebe 
take me with you - chameleon 
harsh symmetry - mirror twin
justice devine - toutes les larmes de mon corps
slasher dave - unearhing the hideous
dream division - lumarian
old tower - woods of algor