#artist - #track
arms and sleepers - blood song
akuratyde & kharm - impressions
biorhythm - hold me tight
instra:mental - elsewhere
alegria & avf - reality test
com truise - brokendate
forhill - supernal
yppah - shot into the sun
boards of canada - aquarius
bowery electric - lushlife
swirlies - house of pancake
coatie pop - siick serenade
tsuko - lapse
alison - overflow
washed out - feel it all around
manitoba - kid you'll move mointains
aerial love feed - raise up
glass beams - mahal
chapterhouse - pearl
slowdive - souvlaki space station
gi gi - delft
caribou - can't do without you
kiasmos - sailed
sorrow - acedia
dunman - morning after dark
drb selects - break the wrist, walk away
infinite scale - i gave up
four tet - two thousand and seventeen
smashing pumpkins - today
