#artist - #track
stones taro - ton tan (tim reaper remix)
doctor jeep - push the body (aquarian remix)
martyn x om unit - the trenches
toma kami - djedje feat amor satyr
anatolian weapons - sunbeam dance
bowery electric - lushlife
manitoba - kid you'll move mountains
massive attack, portishead, tricky - angel
martyn x om unit - basilisk
idaly - let me zien (jailo edit)
mfana kah gogo - jabula
swimful - viatica
monter - no good 
chrisman - another banger
gafacci - ghana original
kelela - contact (surreal sessions bootleg)
jailo - coke money
bok bok - l'chordian
dj lag - chaos
gafacci - amazonto
arma - favela (murder he wrote remix)
cartridge & biome - ricky rose
klimeks - spirit void
ciara - i bet (hyades remix)
indi, pholo and kareful - second sword vip
hyades - xtc 
leo cap - free your mind
benga & coki - night
benga & coki - night (egoless remix)
balkan beat box - joro boo (bbb remix)
shazalakazoo - bobangola
killjoy & kwam - active
sam binga, redders, gemi - oh my gosh (gemi remix)
breaka - leave your dirt at the door (disaffected remix)
househead samira - radio safia
dj godfather - warehouse muzik
big dope p - 75013 methods
joker - gully brook lane