#artist - #track
moskwa tv - futuristic dance
debbie deb - when i hear music
jamie jupiter - computer power
luca dell'orso - pulsario
international music system - dancing therapy
quadrant six - body mechanic
midnight start - freak-a-zoid
cybotron - clear
kraftwerk - the model
adrian marth - new vision
boy harsher - give me a reason
the fascination - the flight
frankie knuckles - your love
palermo disco dquad - after all these tears
o'gar - playback fantasy
casco - cybernetic love
the juan maclean - give me every little thing
dazz band - let it whip
bar-kays - freakshow on the dance floor
debarge - rhythm of the night
ollie & jerry - there's no stoppin us
shannon - let the music play
the whispers - rock steady 
cameo - candy
l'trimm - cars with the boom
lisa lisa & the cult jam - i wonder if i take you home
new edition - cool it now
vanity 6 - nasty girl
corina - temptation
pretty poison - catch me i'm falling
rocksteady crew - (hey you) the rock steady crew 
midnight star - no parking on the dance floor
the egyptian lover - egypt egypt
drexciya - wavejumper
waveshaper - let's escape together
company b - fascinated
nuovo testamento - the searcher
korine - the last 
blakk harbor - patisia city
jason priest - be thankful, billy