#artist - #track 
normal bias - another realm
skinny puppy - smothered hope
oliver decrow - i touch you
pankow - das wodkachaos
borghesia - ni upanja ni strahu
mvtant - just one touch (kontravoid remix)
museum of devotion - devotion 
cetu javu - situations
sacred skin - fever
the cure - a night like this
the human league - seconds
q lazarus - goodbye horses
miss kitten & the hacker - leather forever
harsh symmetry - mirror twin
mareux - the perfect girl
crystal castles - afflicton
shriekback - nemesis
the sisters of mercy - lucretia my reflection
moth - obelion disco 
drab majesty - kissing the ground
tones on tail - go!
alien sex fiend - dead and buried
berlin - the metro
riki - charming world
pink turns blue - walking on both sides
wingtips - accidental effigies
the cure - boys don't cry 
spirit host - howl 
the chameleons - the fan & the belows 
shadowhouse - conformity 
the soft moon - far