#artist - #track
arpanet - illuminated displays
body language - when you left
volor flex - backward
ryan hemsworth - snow in newark (chet porter remix)
lido - money (luca lush edition)
djedjotronic - traffic
2nd sun - metro
likhan - boxin
acemo - gat in my lap
cyphr - gloss finish
djedjotronic - abyssal zone
justic - phantom (our time remix)
polar youth - bae (ollygon flip)
color plus & kanyon - whip n flip
salva - 3rd world ft. scottie b and astronomar
astr - blue hawaii (brenmar remix)
mila j - drink smoke breakup
spurz - black locks
p-80 - sherbet land
skittlez w skit
jackal - chinchilla
migos - versace
krne - avalanche
slow magic - waited 4 u (odesza remix)
geotheory - finally
nina las vegas & swick - flash auto
curious kontrol - all this time
stick - queen of hearts
diinch - baby it's you (chromatic remix)
dj sliink x twrk x green lantern - trifecta
tnght - acrylics
row d - i'm a grime kid
ghost mutt - oh boy oh boy
yellow claw - never dies (gent & jawns remix)
lookas - genesis
easy girl - hey girl
aleronics ft migos - figgity figgity fucked up (dubskie x carnage edit)
jawz - after dark
starkey - screwed on (ft. d double e)
nght drps - trippy
louis futon - mojito
og kush - left behind
lux johnson - paradox
diplo - revolution (krne remix)
maxx baer & daffy - summer falls
baauer - one tought (luca lush x dirty chocolate remix)
clams casino - i'm god (p-80 footwork refix)
taso - drop that thang
freeway & girltalk x tycho & com truise - yeah i'm awake (hood internet mashup)
usher - you make me wanna (krne remix)
beach club & relic - charly
dj spinn & taso - burn that kush
yellow claw - dancehall soldier
terrorythmus - jungle tekno
homesick - lolrave
wu tang clan - cream (green lantern remix)
luca lush - shvke
migos fight night
p-80 - real levels
krane x portrait - chandelier
izy - why