#artist - #track
rome - i belong to you
john newman - love me again (gryffin remix)
my nu leng - no 2
walton - amazon
fisky - m stabs
normaling - low drop (feat. rye rye and tt the artist)
sugar shane - kill da bitch (lil texas remix)
shepherd - kippenhok
wiwek - mango chutney
yellow claw - dj turn it up (tighttraxx & etcetc remix)
clicks & whistles - cackalackin'
lockah - the sour drink from the ocean
cdbl - i need you
max baer - automatic (alexandre remix)
obey city - quantum phase
skit - waves
bobby tank - needin me
krane - aryah
awe - crystals
joker - purple city (swindle remix)
bob marley - is this love (chachi & musicman ty remix)
panama - always (waveracer remix)
boeboe - we feelin' (parkinson white flip)
jay-z - big pimpin (kid cedek x niko javan remix)
stwo - aura
imogen heap - just for now (ozzie x hucci remix)
rl grime x what so not - tell me (ganz flip)
ugk, outkast & george michael - international whisperer's anthem
uz - trap shit 14
deon custom - circles
peachboy - reverse cowgirl
joker - mario ting (kragen remix)
nelly - country grammar
brandy - pain this house (ticklish remix)
louis futon - parasail
cypress hill - hand on the pump
jerimih ft yg - don't tell em (alesia remix)
lil jon - turn down for what (hank hill remix)
misterwives - reflections (remix)
sky ferreira - you're not the one (cid rim remix)
darq e freaker - yeah yeah yeah (dun know)
pomo - aerobix
the xx - shelter (them jeans drum edit)
animal collective - my girls (hatchmatik disco bootleg)
cut copy - lights & music (moulinex remix)
cakes da killa - i run this club (curl up remix)
joker - tron (kromestar remix)