#artist - #track
faith no more - epic
sly fox - let's go all the way
falco - rock me amadeus
girl talk - let it out
bubba sparxxx - ms new booty
krne x portrait - chandelier (remix)
baauer - one touch
aquadrop - bloko bloko
spankrock - assassin
tinashe - 2 on ft. schoolboy q (luca lush remix)
knightlife - don't stop
the swiss - kiss to kiss (breakbot remix)
lifelike ft a-trak - don't stop
david bowie - rebel rebel (dies d-edit)
midnight juggernauts - shadows
emynd - nowhere to run
snavs & fabian mazur - get em
migos - versace
m.i.a. - xr2
bleep bloop - a drop from a cloud (pluto dash remix)
lest diet - garaj mahal
axel boy - the future express
the rapture - whoo! alright - yeah... uh huh
color plus & kanyon - whip & flip
emynd - flip it snap it
easy girl - hey girl
jessie j - bang bang
gent & jawns - kings
asap rocky - fashion killa (p-80 footwork refix)
sabbo - time to get dumb
maxx baer & daffy - summer falls
baauer - one touch (remix)
the knife - heartbeats