#artist - #track
terence hannum - total dissolution
nurse with wound - creakiness
the stranger - exhumation
killing sound - sixxx harmonies version
survive - parousia
the hunt - the abomination
chris & cosey - driving blind
white car - in the second month of the year
shadow coat - la forme lente
sandra plays electronics
moth - taste the remains
kangding ray - amber decay
rrose - pentagons
lakker - mountain divide
mahr - seven pillars of the dweller
diamanda galas - the litanies of satan
slasher dave - half past midnight
synthamesk - evil
nostalgic fantasy - angel's of the night
black rain - xibalba road metamorph
house of black lanterns - you, me, metropolis
pretty bleak - old house
demdike stare - past is past
lorn - oxbow b
saddest bot alive - 自殺
vt - bludgeoned
cosmetics - black leather gloves (premier rang rmx)
keys n krates - yes we faded
skinny puppy - last call
lust for youth - new boys
chromatics - cherry
michael boyd - unsolved mysteries theme slowed down six times