#artist - #track
LCD Soundsystem - 33 45 Part 1 (Apt 1 refix)
Joakim - I wish You Were Gone (Dub mix)
!!! -Intensifieder (Sunracapellectrohshit mix 03)
Curses! - The Deep End (Holy Ghost! Remix)
When In Rome - The Promise (Coliseum Mix)
Division Kent - L'Heure Bleue (Keenhouse Remix)
College (feat Minitel Rose) - The Energy Story (DVAS Remix)
The Bar-Kays - Do It (Romeo Erotic Remix)
RCMP - The Bird AKA Ignition (12" Promo Mix)
The Supremes - Come See About Me (Joey Honey Double Ross Mix)
Discodeine - Joystick
Mr. Oizo - Patrick122 (Extended Saxophone Break Edit)
Prinzhorn Dance School - You Are The Space Invader (Optimo Espacio Remix)
Tiga - Shoes (Spencer & Hill Remix)
The Hood Internet - Belonging It Up (Lykke Li vs Hercules & Love Affair)
Flosstradamus featuring Caroline Polachek- Big Bills (Jokers Of The Scene After 4AM Rework)
Bat For Lashes - Daniel
The Black Ghosts vs Lindstrom - Something New (Galactic Version)
In Flagranti - firmly planted memories
O'Bryan - I'm Freaky (Treasure Fingers Reflip)
Air - Mer du Japon (The Teenagers Remix)
College - can you kiss me first (1928 remix)
Alexander Robotnick - the dark side of the spoon
Bangcock Impact - aspirin
pluton & the humanoids - world invaders
Juvelen - Watch Your Step (Krazyfiesta remix)
Friendly Fires - Skeleton Boy
Brooklyn Express - Sixty-Nine
Peter Bjorn And John - Inland Empire (Friend Mix)
Shoes - Are You Crazy?
Escort - Drums of Death remix
LL Cool J - Jingling Baby
Berlin Symphony Orcestra - Dance of the Sugar Plum Fairy (Red Baron Remix)
Shoes - Get Soul Power Right
Modeselektor - DÃƒÂ©boutonner (Feat. Siriusmo)
Lindstroem & Solale - Let's Practise (Dub Mix)
Passion Pit - Sleepyhead (Elijah's Beat Generation Remix)
Peter Bjorn And John - Lay It Down (The Golden Filter Remix)
John Lennon - Oh Yoko!! (Pocketknife's Numero Ono Refix)