#artist - #track
Paul White - Sleep Clapping
Benga + Mims - This is Why Im Crunked Up
Mount Kimbie - Sketch On Glass
Cerebral Vortex - Nineteeneighty feat Stray
Little Boots - Remedy (Rusko's Big Trainers remix)
The Widdler - Its a Fine Day Bootleg
The Widdler - We Ready (tease)
Borgore - Foes (16bit Fuck Hoes Remix)
Mark Pritchard & Om'mas Keith - Wind It Up (Original Mix)
Reso - Busted Crunk
Hudson Mohawke - Overnight
The Hood Internet - Who Ain't I Gonna Run To? (Yung LA vs Solid Gold)
Crime Mob - Knuck If You Buck (Pistol Pete remix)
Little Boots - Meddle (DESIGNER DRUGS 80's COKE JAME REMIX)
Gucci Mane - Pills (Proper Villains Remix)
Slugabed - Clunk Clunk
AFTA-1 - Nightlight
Bullion - Long promised
The Heatwave - Heatwave Affair
Ooah - Crunk Down Where Ya At
Wu Tang Clan - Stomp (The Bloody Beetroots Remix)
Vent - Crystallite (Deviant Edit)
Venetian Snares - Horsey Noises
The Rogue Element - Escalation
Futurecop! - Ain't That Fresh
Joker & Jakes - 3Klane (L-Vis 1990 Dubble Step Edit)
The Streets - Blinded By The Lights (Nero Remix)
Bone Crusher - Never Scared Remix (Dirty)
TI - Dead and Gone (Kid Simple remix)