#artist - #title
khanyisa, tyler icu, nandiph808, ceeka rsa - suka
kevin kofii - shifting directions
idaly - last me sien (jailo eidt)
dj polo - burndown
toma kami - amapicante
siu mata - tokamak
doctor jeep - gte
mura masa - lotus eater (egnever amapiano edit)
fiyadred - overtime
sage the gemini & kwamzy - gas pedal (dj shoes amapiano edit)
sobotik - signal
jlin - dissonance
destrata - desire signal
shy fx - original nuttah x killin dem (kybba elexsandom edit)
four tet - plastic people
ivy lab - look away
silas & snares - biometric
dj jm - erazer
lv - uthando lwaka (feat. ruffest)
lofty - joyless
juicy j - purple kush
joker - purple city
ludacris - how low can you go
j beatz - sour diesel
clicks & whistles - cranberry goose
taiko - crumpets fet. ed hodge & sam berry
kali - sober
l-wiz - girl from codeine city
debba - just wanna (pluralist remix)
opus - figures
glume & phossa - close enough
kin teal - patio dew
settle down & lovely - the ride
instra:mental - when i dip
freak nasty - da' dip
client_03 - unity candidate
deep blue - helicopter tune 
88.3 - wishing on a star
new blood - worries in the dance