#artist - #track
rohaan - easy for them
bianca oblivion & onhell - sinais (glitch mob remix)
doctor jeep - i'm running
t. williams - jammy
kin taal - patio dew
awo ojiji - woozy
al wootton - xana
rhyw - engine track 
de grandi - of course
joker - s waveshaper
hijinx - swarm
ma-g0 - the psychwxrd is wxrning
vinter - one last thing
almogfx - exalt
nueq - viernes
aphex twin - windowlicker (nyrk edit)
homesick - hardcore!
chrissy - you don't have to worry (big ang garage remix)
shy fx & uk apache - original nuttah (bullet tooth bootleg)
danny scrilla - or u 
nikki nair + dj adhd - where u find this
yedgar - stunlock
homesick - rune faucet
batu - other means
3phaz - bravamax
bone box - gang
cesco - up the place
fracture - all of the massive
y u qt - freedom 2 dub
posij - for your eyes
fred again + baby keem - leavemealone (nia archives remix)
slowrolla - simple
samurai breaks & napes - wavelord bizniz
k.l.o. - hyper metals
delayz - rattlesnake
mindex - dark matter
mr. jay - feel the bass 
hyades - sight
nueq - ammonites wall