#artist - #title
clovd cvp - what you want 
sorza - never
swimful - good morning
ma sha, sobolik - liftoff
tenebre - fft
quest?onmarq -trustfall
teqmin - hand full of fluff
sam binga & fracture - trippin'
djrum - codex
md20 - midnight air 
protect ryan - macro beats for micro bois 
andrew huange & undulae - zobel
norfik - granular motion
binary digit - p5hd-165tekmix2
minor science, seppa - reckless daddy
ozoyo - flatworm meets sea slug
jay carder - mekosha
train to eltanin - f.b.n.
trngs - teeeth
la dama - full metal eagle
doctor jeep, tamarak - destroyer
luca duran & atrice - hoasca
photon - ain't ready 
eyra - gyre
fels - silver lining
siu mata - tokamak
dj polo - burndown
hijinx - danger
sobolik - signal
benyayer - domiray
ivy lab - look away
drummy, martini - persuasion
kaval & wrack - dizziness (kaval weird birds remix)
pepe - jagged edge
lutsu - sweetest dreams
aya - lip flip
debba - just wanna (pluralist remix)
de grandi - valve
viaan - staccato
ziyiz - prescience
hexalyne - invicate
coido - box
objekt - chicken garaage
squarepusher - my red hot car (girl)
braille - summer sizzle