#artist - #title
nine inch nails - closer
futuro - terra incognita
normal bias - another realm
skinny puppy - deadlines (remix)
oliver decrow - i touch you
cosmetics - black leather gloves (remix)
forces - ice (fleisch edit)
anna funk damage - punk girl
ssleeping desiress - christine perfect
soft kill - cicero
luca dell'orso - pulsario
mareaux - the perfect girl
pale fortress - keygen girl
crystal castles - kerosene
soft crash - haute surveillance
boy harsher - pain
gatekeeper - giza
void vision - sour (vanzetti & sacco remix)
miss kitten & the hacker - leather forever 
the neon judgement - fashion party
ausgang verboten - consumer
moth - obelion disco
joy division - she's lost control
leroy se meurt - angoisse
curses - elegant death 
vvv - siroco
q lazarus - goodbye horses
shad shadows - bound 
crystal castles - sad eyes
artemas - i like the way you kiss me 
pressures - abnormal
fangs on fur - snake 
berlin - metro 
silent em - don't crash so fast 
the soft moon - far
ho99o9 - off the meter