#artist - #track
bauhaus - bela lugosi's dead
Joy Division - digital
Flowers & Fire - substance
the adverts - gary gilmore's eyes
ads - waiting for the war
The Cramps - what's behind the mask (demo mix)
kill van hellsing - i've been decapitated by a manic fiend
misfits - halloween
Ritual Veil - all black
Teeel - the lucania
portion control - divided
tense - disconnect myself
Phase Fatale - hollow flesh
skinny puppy - testure
VISITOR - imp
stereo - somewhere in the night
depeche mode - behind the wheel
Forever Grey - the style is death
future - side effects (dead remix)
Lebanon Hanover - kiss me until my lips fall off
pixies - gouge away
sisters of mercy - dominion
Ssleeping DesiresS - les fleurs
Children on Stun - sidelined
NIGHT SINS - enamored and nailed shut
ACTORS - bury me
the human league - the lebanon
Ritual Howls - park around the corner
the cure - the walk (razormaid remix)
Void Vision - sour (remix)
Winter Severity Index - a sudden cold (h0rd remix)
keine ahrnug - plastik
Xeno & Oaklander - sheen
totem - lifelines
moth - obelion disco
rendes-vous - workout
ALL YOUR SISTERS - a perfect body
Crim3s - holes
Crystal Castles - sad eyes
SIDEWALKS AND SKELETONS - ascention
miss kitten & the hacker - leather forever
COLD CAVE - love comes close
new order - temptation
Fearing - into the fog
Selofan - vitrioli
de ambassade - wat voel je nou
de ambassade - geen genade
soft cell - sex dwarf
Death Bells - alone into an empty clearing
joy division - shadowplay
veda - whiplash
Geometric Vision - solitude of the trees
Twin Tribes - dark crystal
The Spiritual Bat - mosaic
Screaming for Emily - the love
crystal castles - celestica (request!)
Ortrotasce - lost love
guardian - thirst (single edit)
kmfdm - juke joint jezebel
Carpenter Brut - inferno galore
Room 506 - drop out
front 242 - headhunter
Hante. - nous ne ferons quun
Drab Majesty - too soon to tell (cold cave remix)
ritual veil - favorite toy
The Soft Moon - far
Fangs on Fur - snake
bauhaus - dark entries
Shadowhouse - conformity
berlin - the metro
ritual veil - gray filter
zwarte police - de laatste dagen
the cure - love cats
Purity Ring - obedear
Portishead - sour times
Cocteau Twins - lorelei
GLASS CANDY - digital versicolor
CHROMATICS - shadow 
trust - shroom
HOLYGRAM - hideaway
nika + rory - i'm not going anywhere
IC3PEAK - nramr
nine inch nails - down in it
High-Functioning Flesh - touch oblivion icon
The Jesus And Mary Chain - reverence
rendes-vous - ignorance & cruelty
depeche mode - shake the disease
q lazarus - goodebye horses
Zola Jesus - night