#artist - #track
skit - lifestream
lethal bizzle - flex (james hype vip)
major lazer - boom (uniiqu3 remix)
neuropunk - mental
aee + bandi - detonate
mr easy - london town (zero fg remix)
dehousy - akaeka
ryuki miyamoto - clap clap
4b & teez - whistle
skepta - man (uniiqu3 & yung kidd remix)
lsdxoxo - death rattle
swimful - offline vip
d double e - nang
mingo - medi
tommy genesis - tommy
silkie - impervious
truth - madman
skeler + juche - proxima
fly - bengali
cashmere cat - 9 after coachella
ldru - shapes (ganz remix)
pusha t - if you know you know
bsn posse - hey break it down (stayhigh remix)
0h85 - i got it
hesk - sprite so pink
esseks - dill
cupcakke - cartoons
yunis - mitra
droeloe - jump
doja cat - go to town
iapetus - magnolia (footwork edit)
0h85 - limon
itoa - you're the one for me
sinistarr - 55555 (philip d kick remix)
dj mcchicken - w8 in gold
dj yen - release
#genres bass, grime, footwork