#artist - #track
magari's kid - pwd
detboi - ice cold (blood on the drums)
oliver yorke - the gift
qzb - unity
blocks & escher - something borrowed, something blue
overlook - magick
artilect - lost
antagonist - lucifer's calling
pessimist - through the fog
4625 - non-citizen
theory - rage inside
forest drive west - jungle crack
dgohn - so be it, lumbrichina
drum - chiari malformations
shift - juju
alix perez - dark star
halogenix - velvet
blue mar ten - titans
hyroglyphics - make me feel
rockwell - user
ricky force - suburban nights
drummotive - synchronism
earl grey - inner conflict
tyr kohout - pemmican
digital - lost civilisation
lewis james - templar III
deep shoq - first encounter
om unit - twilight
magari's kid - halt