#artist - #track
the sprawl - haptic feedback
aqxdm - ballad 002
ansome - british steel
broken haze - rx-7 re;amemiya
schwefelgelb - obwohl es so aussieht
microlith - another way
ansome & ossian - death +1
chants - amythyst dust
maere x holly - random title
shalt - the treatment (zuir remix)
le dom - oazis (liar optimix)
yaporigami - PLMS_IV_D
maelstrom - czarna woda
daed - pnoise
vzetxh - jovupiac_wave
bewwip - ttemplate k mix
hitori tori - kaeirn
kettel - inman
goreshit - mode 7
doormouse - skelechairs (venegian snares remix)
ulcerium - collapse
blush response - dead still air
headhunterz, wildstyles & noisecontrollers - world of madness
goreshit - 26arp
hardsequencer - brain crash
da predator - dubplate style
stazma the junglechrist - electric voyage
doormouse - for mama's
scooter - friends turbo
gizmode - snaregasm
rob gee & ralphie dee - sex drugs and gabba house
broken haxe - wizard eyes vip
aaron spectre - you don't know
ceephax - trolley service
evol intent - flipside
electromecca - electric
ruby my dear - spectacle
ulcerium - collapse
sophie - immaterial
aphex twin - boy/girl song
