#artist - #track
logistics - chant
strategy - lanterns
chump change - every legend
sepia - so fine
philip d kick - in formation
bsnposse - drifting
limit - sovremennik
leatherface - din daa daa
letryp - footworkin
hyroglyphics - cheyhboi
touchysubject - syncronisation
dj earl - i have all
dj spinn, rashad & sinjin hawk - monterrey
charlie scott - eye love
sully - 368ft high & rising
breaka - damn hot (danny scrilla remix)
sinistarr - 55555 (philip d kick remix)
alix perez & chimpo - dead
symbioticsounds - summer wind
0h85 - i got it
binary digit - berriat acid
bsn posse - hey break it down (stayhigh remix)
teep - sumn
symbiotic sounds - like this
iapetus - what u like (long distance vip)
juke dealer - get it
sevyn streeter - don't kill the fun (0h85 remix)
dj yen - release
0h85 - slippy
kelis - brave (dark sky remix moondoctor 160 refix)
glophase - boone's farm