#artist - #track 
rootkit - good 2 go
bassboy - bad boy
straight razor - the adversary
with you - snaps
walton - snaps
preditah - touch road
zeke beats - starbound
juicy j - all i blow is loud
g jones - signal
caspa - get higher
meridian dan - german whip (remix)
sekko - militant 
capo lee - mud ft d double e
javascript - hottt
chayse - walls (5kinandbone5 3d virtual cybersex slut dub mix)
deon custom & glacci - zaffre
klasey jones - yoko & ano
somba - fake bling (fake love remix)
rihanna - pour it up (rl grime remix)
1991 - bohemian
sorsari - moonstone
migos - slippery
lyk -dice
zeke beats - dispatch
graves x krane - spells
krane x dnmo - sakura
kardinal offishall ft akon - dangerous (breaka vip)
bsn posse - what u know
pg & dubsnit - music for da yolks
shades - hypeflex