#artist - #track 
tricky - suffocated love
boards of canada - roygbiv
bibio - busines park
bop x synkro - telescope
dbridge - rendesvous
instra:mental - watching you
nuage - endles green
rando - quavers
alias - unseen sights
cocteau twins - cherry coloured funk
boards of canada - everything you do is a balloon
bibio - A Tout A L'Heure
gaslamp killer - turk mex
telefon tel aviv - fahrenheit fair enough (prefuse 73 remix)
gangstar - mass appeal
elaquent - through the looking glass
teebs - wind loop 
aphex twin - alberto balsam
baths - aminals
gold panda - you
calmer - spirograph
manitoba - kid you'll move mountains
bullion - you still believe in dee
prefuse73 - it never entered
digable planets - rebirth of slick
dj shadow - mutual slump
my bloody valentine - soon (andrew weatherall mix)
slowdive - 40 days
glass candy - digital versicolor
puriy ring - obedear
alex - teenage
chromatics - shadow
dye - fantasy
tycho - l (dusty brown remix) 
chris issacs - wicked games (trentmoller remix)
sorsari - aurelie
clasey jones - cement
roel funcken - styx
xi - villian
roof light -aracadian
caribou - sun
burial - archangel