#artist - #track
straight razor - the adversary
microlith - another way
oddlogic - hex
my nu leng & krywolf - what you feel (feat kiko bun)
otik - acne downs
low pulse - metatron
zeke beats - starbound
dalhas umai - monark
plant42 - fluid reasoning
shinra - coslin
special request - redrum
dwaallicht - sigil 118
vaetxh - us amoung stars
sekko - boxes
sorsari - sacred
analogical force - debt loop
daed - focal plan
mnlth - traffic
carfinlow - atomic level
traffik - ammonia party
g jones - helix
zeke beats - dispatch
traxman - slash time
dalhas umai - knight dance
dj earl - gettin blowed
hydrecta - seagate
taso feat dj rashad & spin - am track
neuropunk - dat astral plane
ivy lab - eyes down
tvb - heart skips a beat
moresounds - ruff times
pzg & dubsknit - music for da yolks
emel - aenigma
o9 - terminal red