#artist - #track
skinny puppy - assimilate
aqxdm - aegis
ansome - vakuum
beverly hills808303 - the american lie (remix)
mescalinum united - we have arrived
rory st john - rotoscopus
pinch - ahh fff sss
special request - brainstorm
textasy - oakleys (hydraulic bass dub)
blawan - kaz
sonic experience - protien (hardcore innovator mix)
terrorize - feel the rhythm
bizarre inc - i'm gonna get you
sonz of a loop da loop era - far out
electroset - how does it feel
criminial minds - re-baptised by dub
krome & time - this sound is for the underground
marveline - learn to love (turbo mix)
praga khan & jade 4u - injected with a poison
tessela - helter skelter
lone - hyper seconds
squarepusher - my red hot car
shinra - coslin
timothy j fairplay - hard ticket to haiti
miss kittin & the hacker - leather forever
rogue frequency - element 94
the future sound of london - we have explosion
kontravoid - hold nothing (schwefelgelb remix)
radical g & the horrorist - here comes the storm
felix da housecat - ready 2 wear (u-terns evening wear edit)
krystal klear - neutron dance
korine - never dream
legowelt - disco rout
glass figure - cold eyes
aphex twin - run jeremy's window licker (x-rated lick)
shinra - pinwheel
traffik - ammonia party
origin unknown - valley of the shadows
fixate - ripgroove refix
omni trio - renegade snares
the house crew - euphoria
mnlth - traffic
the tuss - last rushup 10
4 wisemen - mind to mind
yolk - music 4 da people
warp addicts - ruffneck n rugged
redlight feat sweetie irie - zum zum
textasy - i'm the needle
jaquarius - incunabulis
cyberchrist - spirit
search & destroy - work it
q project - champion sound
aphex twin - cock/ver10
kettel - inman
dj food - scratch yer head (squarepusher remix)
portishead - sour times