#artist - #track
neud photo - suspicion
aemit - hunter
coil - doet / hecate
shaddah tuum - suninyourhead
paul jabanasam - search another 3H0 = lose you i), place !=0 doubt I V (o) am exp(/ 16r to meet you again pm2 Po
belief defect - disembarking horizons
alpha * necromante - solve et coagula
randolph & mortimer - exclude-divide
daniel holt - apathetic deceptions
lvrin - cyber
night sins - annihilator
teatre - mankurt
lucy cliche - cliche's principle
multiple man - high on the hog
einsturzende neubauten - trinklied
foricata - stencil
xeno & oaklander - insomnia
bambara - dark circles
exhausted modern - nekam nesen
anna funk damage - wher's the way god
haunted crusades - comfort zone
ministry - the angel
shad shadows - minor blues
test - ready to die
broken english club - the modern desire
the sisters of mercy - alice 
the spiritual bat - mosaic
crim3s - stress
blue anxiety - uninvited to the funeral home
sebastian swarm - exercise and harness
death crux - phantom blood
the soft moon - far
wingtips - accidental effigies
sidewalks & skeletons - alice practice
catslash - paf
alessandro adriani & michel amato - liar
estado critico - what's up with the crazy man
aqxdm - ballad 002
abnormalities - voyager
w/out - they saw us laying there
plant43 - inward strem
hante - my destruction
real life - send me an angel (89 dance mix)
korine - heaven's servant
a homeboy, a hippy and a funky dread - hardcore heaven
pzg & dubsknit - trouble roots