#artist - #track
dwaallicht - 32614
Austin Speed & Calculon - get murked
Slick Shoota - so good
DJ MADD & jon1st - roots fashion
rohaan - run human run
posij - on the one
Capo Lee - ching bang wallah
joy o x Boddika - mercy vip (slick shoota remix)
Anna Morgan - my gyal dem
Wevlth - imminent
Goth Trad - nerve agent
Reso - flexible neck
ruse - move from the gate
ruse - the rules
HOMESICK - running on empty
Pablo Dread - fyah burnin
a-0 & viberous - this against that
double 99 - ripgroove (fixate remix)
LSDREAM & com3t - hello human
Shades - iron sharpens iron
rukus + magugu - flow (ali mck & IYZ remix)
Root For The Villain, ronin - dose
tenka, tali rush & drama b - hadouken
GIRL UNIT - pull up
Flume - jewel
lsdream & Champagne Drip - eternal now
Sematary Kid - infinite (2019 remix)
Tes La Rok - up in the vip
Kromestar - emperor's call
loneliness - stem cell
unholy, Juche - transmission & fusion
martyn - recon
TEXTASY - blow your head
dayzero - down by law
Scarlxrd - 6 feet
barnacle boi - have hope
Skeler - arcadia
Sorsari - the threads 
capo lee - dream
L-Wiz - girl from codine city
Benga & Coki - night