#artist - #track
q lazarus - goodbye horses
boy harsher - motion
tobias bernstrup - 1984
laserdance - humanoid invasion
o'gar - playback fantasy
ladytron - playgirl
void vision - sour (vanzetti & sacco remix)
ortrotasce - lost love
broken english club - domestic animals
depeche mode - shake the disease
miss kitten & the hacker - leather forever
crystal castles - sad eyes
schwefelgelb - dutch die haare die stirn
moth - obellion disco
korine - heaven's servant
future - side effects (dead mix)
gatekeeper - oracle
purity ring - fineshrine
kareful - in the dark
sorsari - children of gaia
ic3peak - i'll be found (sidewalks and skeletons remix)
grimes - oblivion
bal pare - palaise b'amour
twin tribes - dark crystal
de ambassade - geen genade
soft cell - sex dwarf
crim3s - stress
sextile - situations
the cocteau twins - feathers-oar-blades
joy division - she's lost control
hante - one more dance 
the chameleons - second skin