#artist - #track
big dope p - bigol butt
dj assault - ass-n-titties
lefty x sideswipe - bad girlz
freshtildef - let me go
w00dy - like what u do
iglooghost - zen champ
chimpo - quick queue
drake - god's plan
youth - club bomb
terrorythmus - sike
dorian concept - toothbrush
sophie - bipp (tielsie remix)
pzg & dubsknit - movin hardcore
konflict - messiah
wisp - lark & lion
hrvatski - vatstep dsp
remarc - r.i.p. (remix)
96 black - celsius loss
aphex twin - cock/ver10
dj slam - looking into the light
scarlxrd - 6 feet
abnormalities - black acid machines
stereoman - waai
sophie - faceshopping
nenah cherry - buffalo stance
paranoid london - blue-ush
biochip c - information superhighway
neon - don't mess with this beat
electroset - the theme from techno blues