#artist - #track
#Disasterpeace - Old Maid
Theologian - Candidate
John Carpenter - Vortex (Silent Servant remix)
WLDV - Cassiopeia
Fraunhofer Diffration - Let Me Go
H0rd - Deliverance
Power Glove - Motorcycle Cop
Blanck Mass - Double Cross
Buio Mondo - Omicidio Sotto Le Luci Al Neon
Nightcrawler - Macabre Serenade (OGRE remix)
The Hunt - Angoisse
Creeper - Phantom Power
Void Vision - Sour (Vanzetti & Sacco Remix)
Chelsea Wolfe - The Warden (Maceo Plex remix)
Guardian - Thirst (single edit)
Ortrotasce - Lost Love
Miss Kitten & The Hacker - Leather FOrever
Dimentia - Human Sacrifice
Sendai - Inverse Array 1
Blush Response - Fenix
Talker - Frame Capture
Bourbonese Qualk - Lies (Ancient Methods edit)
Veil of Light - In Ruins
Lebanon Hanover - The Crater
Shaddah Tuum - Merkabah
Kuedo - Boundary Regulation
Carpenter Brut - Invasion A. D.
The Hunt - Brain Test
Headless Horseman - Blood Drop
Boan - Freak Snake
Alessandro Parisi - Calamitas Calamitarum
High-Functioning Flesh - Touch Oblivion Icon
Nine Inch Nails - Down in It
Gost - Cascade