#artist - #track
boogie dan x ticklish - you don't know my name
alix perez - revolve-her
bsn posse - down in my soul
dj earl feat taso - smoke dat green
nuage - endless green
bahnhof::zoo - talk'n bout anything
taso - saxxx
supraman - hit it right
taal mala - do it
brandy - paint this house (ticklish reboot)
footmerc- ez does it (control of your mind)
glamour gold - feel (mix 1)
ruffhouse & clarity - aphasia (sam binga & redders remix)
richie brains - bring dat back ft killa p
leviticus - burial (logistics remix)
dope skillz - 6 million ways
dj rashad x spin x taso - luchini vip
dj rashad - pass that shit (feat spinn & taso)
dj earl feat moondoctor & opn - smoking reggie
dj earl & manny - we do this
artificial intelligence - shrine
bsn posse - get u
dj taye - that love
marvellous cain - dubplate style
flamingosis - next to you (ticklish edit)
tropmanga - pon di rock
high contrast - twilight's last gleaming
dj amex - und
dj mcchicken - w8 in gold
snappy jit - she like my step (feat chad.)