#artist - #track
dark sky - em cy
kowton - shots fired
cassini - lemsippin
athletixx - pnthr
torso - fat vint (liar optimix)
baauer - make it bang (feat tt the artist)
fisky - raiden
d'arcangelo - timeless (kettel remix)
miami beach force - hard to catch
q3a - untitled
de grandi - match
distal - the big gheti star
bios - ashki chronicles
dreem tran's - deus ex machina
drake - b2b (j heat remix)
rustie - big carzz (rojazu reboot)
zeke beats - virtual purple
darq e freaker - venom
dj compton - tyga edit
lil boosie - wipe me down
stayhigh - light that shit
tommy trash ft anna lunoe - me & u (big dope p remix)
alix perez & ivy lab - stop it
greyhat - open it up
50 cent - hello disco (paxel remix)
popcorn10 - dolphin
waveshaper - crystel protocol
the knife - heartbeats
mercurial - feel the energy
dj rashad - acid bit
baauer - temple (feat mia)
mikos da gawd - make a wish
lazerhawk - redline
kid antoine - bodypaint
lux impala - frontin
black nut - 넌 뒤졌네
jeremih - don't tell em (midas hutch)
ty dolla sign - paranoid (hoodboi & falcons remix)
marveline - learn to love
krome & time - this sound is for the underground
three 6 mafia - stay fly