#artist - #track
kendrick lamar - untitled 02
kid antoine - flood control
tsunga - drip diet
dreem tran's - yo bish
mutual friend - perfection
spurz - ornate reflex
mole - sounderror
sega bodega - sun loop
swisha - bomb track
benga - power
doctor jeep - phantasma
tsunga - hog's boss
noah b - xxxx
low deep & kano - get set
dark0 - amethyst
le dom - bayern
crazy titch - world is crazy
glacci - silver stream
beyonce - formation (wreckvge & rigby remix)
fracture, spinn & taso - acid claps
johnny megabyte - homicode
e.t.m - deadarpeggio
jalen - anything
thug entrancer - tight lean
fracture & deft - i just
sushi samson - laika
alizz - your love (hoodboi remix)
seablaze - '97 interactive
footmerc - toe 2 toe
oh85 x b3no - turn love around
boogiemann - misery
surly - our love
greyhat - open it up
asagaya - feat jay prince - washy