#artist - #track
flume - never be like you (wave racer remix)
m!ngo - you don't know m3
kastle - holographic
klimeks - eternally yours
giggs - whippin excursion
salva - get a life
ase manual - bae area
broken haze - celica
krne - aryah
rihanna - bbhmm (brenmar & gutta remix)
bsn posse - not far from the future
mace - touch me
loefah ft fudz - my g sir spyro - topper top
deadcrow - 0verload
dark0 - luka
max styler & audiobot - rule the world
dawn richard - not above that
dark0 - evisu (remix)
swindle - conecta
brenmar - award
ty dolla sign - familiar (remix)
whispa - ezlo
french montant - pop that
big dope p - lapdance
birdman - pop bottles
813 - idk
jucy j - scholarshop
bsn posse - something about us (vip)
taal mala - do it
nelly - country grammar
myrne - sanctum
chimpo - ram dance man
enschway - papercut
rp boo - let's dance again
machinedrum - white crown
ilovemakonnen - tuesday (0h85 edit)
usher - i don't mind (0h85 edit)
lil boosie - wipe me down