#artist - #track
koreless - mti (twrk remix)
zeke beats - meltdown
taso - saxx
lone - triple helix
sinjin hawke x dj funk - three fine hoes (mr fuzz remix)
stelouse - zone (bentz remix)
richie brains - dem a talk bout ft. trigga
hudson mowhawke - system (armnhmr remix)
t-pain - look at me (remix)
? - prima
max styler & audiobt - rule the world
zomby - polka dot
na - brass claim
lloyd sb - boida flare
felmax - yeezy
joker - only you
deadcrow - idk
stanton warriors & tony quattro - keep it movin (falcons remix)
fisky - activate
fisky - diesel
detboi - get on up
1180 - lick it
falcons & juelz - gyal dem move
deadcrow - wifi
m.e.s.h. - follow & mute
dj marfox - b 18
mahs - stay right there
sevyn streeter - don't kill the un (falcons & tony quattro remix)
seapoint - triangle optics