#artist - #track
moby - go
terrorize - feel the rhythm
sonic experience - protien (hardcore innovator mix)
praga khan - injected with a poison
sl2 - on a ragga tip
soundcorp - dream finder
smart e's - sesame's tret (krome & time remix)
marveline - learn to love (turbo mix)
krome & time - this sound is for the underground (e.5 remix)
the prodigy - everybody in the place (fairground)
ellis dee & swann e - roughneck business
criminal minds - re-baptized by dub
taka boom - feel that feelin
nrg - feel the fury (piano remix)
serotonin - rumblism
auora - sunshine
origin unknown - valley of the shadows
the fugees - ready or not (zinc remix)
vibes & wishdokta - want your love
fat controller - in complete darkness
johnny jungle - killa sound
topcat - push up u lighter
jimmy j & cru-l-t - ool lorthoc
search & destroy - iron man
kartoon - soundboy surrender
supa ape - raggamuffin
zinc - super sharp shooter
brisk - airhead
wedlock - ganjaman
krome & time - ganja man
rude & deadly - mash dem down 