#artist - #track
paul jabanasam - search another 3Hφ˙ = lose you i) place i=0 doubt I V (φ) am ∝ exp( √ 16π to meet you again pm² P φ
the sprawl - from wetware to software
ling - canthem
angel-ho - auto shade
munguugnum - ancient alients
sudanim - lightmare
timbah - my head
acre - flash speed
spurz - ornate reflex
mutual friend - perfection (liar optimix)
mutual friend - cylinder
tsunga - masstext
bob traxx - devil drumzz
cassini - fermi
akkord - typeface
duct - it's jungle (flex remix)
phat chex - puxton bridge
maelstrom - the line
logos & mumdance - dance energy (89 mix)
robotiko rejekto - rejekto
tgt (the genetic terrorists) - revo (eon mix)
otik - emphasis (liar optimix)
ontal - sojutsy
dehousy - manda le (liar optimix)
sudanim - sideman
lorn - mount kwaku
marcx - caged
lydes - leaving thrice
dreem tran - deus ex mechana
rabit - so clean (drippin remix)
dark0 - amethyst
gundam - sniper wolf (logos + mumdance mash)
wiley - from the outside (special request vip)
korma - orloj (liar optimix)
hypersport ltd - muta8
loom - boy racer
iljuswifmo - alcala
particle - absolute zero
partisan - magma
bloom - gquartz (starkey remix)
elf kid - gosh (boylan mix)
special request - tractor beam
basic rhythm - raw basics
seablaze - shimikaze
duckett - lightning storm
alix perez - u
c mantle - shrouder
somatic responses - pattern 2.6
fracture - black pearl
rabit - tearz