#artist - #track 
umberto - night fantasy
biosphere - with precious benefits to both
dave graw - realizing total rest
slasher dave - moldy coffins
zombi - time of torubles
creeper - winter intervals
carpenter brut - invasion ad
survive  - omniverse
mike simonetti - the magician
alessandro parisi - calamitas calamitatum
broken english club - plastic bag
high functioning flesh - touch oblivion icon
october - ritual
youth code - anagnorisis
gatekeeper - visions
kuedo - slow knife
depeche mode - never let me down again
cosmetics - black leather glove
h0rd - deliverance
chromatics - shadow (last dance of the night club edit)
kareful - lost
brothel x sidewalks and skeletons - glass coffin
ktng - tomb
blvck ceiling - ghost
kareful - in the dark
halls - roses for the dead
river bones - aus ruinen
cat - bore hole
trash lord - skylines
sorsari - children of gaia
ic3peak - i'll be found (remix)
rustie - tempest
fraunhofer diffraction - black slough
clan of xymox - masquerade
body of light - tremble
kareem & huren - rituel sonore
shifted - flatlands
schwefelgelb - balancier dich
skinny puppy - deadlines 
ou est le swimming pool - jackson's last stand
gatekeeper - obsidian
void vision - sour (vanzette & sacco remix)
pure ground - second skin
black swan - part III
miss kitten & the hacker - leather forever
echo and bunnymen - the killing moon
room 506 - drop out
severed heads - dead eyes opened
le fete triste - night-gaunts
ortrotasce - lost love
depeche mode - strangelove
moth - obelion disco
lebanon hanover - midnight creatures
crystal castles - not in love
peter murphy - cuts you up
deathday - after dark
phosphor - skull
clan of xymox - cry in the wind
alessandro cortini - rispetto
vimmer - antauschung