#artist - #track
survive - low fog
brothel x sidewalks an skeletons - glass coffin
kareful - lost
hnrk - abyssus
ktng - tomb w/ kloudbug
blvck ceiling - ghost
kareful - in the dark
halls - roses for the dead
river bones - aus ruinen
sorsari - children of gaia
deadcrow - last kiss
misogi - blackheart
cat - bore hole
trash lord - skylines (ft. whispa)
dj heroin & hnrk - neophyt
ic3peak - i'll be found (sidewalks and skeletons remix)
rustie - tempest
l'enfant de la foret - a secret
fraunhofer diffraction - black slough
yedgar - bahamut
dreamhaze - loop
ooooo - burnout eyes
as1 - kill the drama
strange vip - cyberomancer 2013
semicolon - creep (666 followers special)
antoni maiovvi - prisoner nightdrive (mircalla remix)
blvck ceiling - hello, mircalla
d/sir - this begins in the dark
(((O)))) - death march
esoteric sob - people without a face (logical disorder remix)
survive - omniverse
violet7rip - u_kno_me
dead sky - cult
vt - i don't make it
evstghxst - over my shoulder
chromatics - shadow (last dance of the night club edit)