#artist - #track
ostudinov - ceydrol
tom hall - linear displacement coninuum pt. 1
snakes of russia - beat adorned
carcass identity - elternlos
sytrjv - asperastal
eczem - rm_3
kiritchenko - facing virtue
meat load - 139imddelayesbg
etch - emmageddon snow waltz
nundale - cosimaa
sam interface - crud
facta - mph
facta - doves
asc - hostile intent
martyn x om unit - passenger
prima ft. killa p - bun down
spd & griz-o - night steppa (unkey remix)
tmsv - mountain (wait here)
pholo x kareful - second sword
bushido - cherry blossoms
graves - genesis
stelouse & sober rob - science
sinjin hawke - in loving memory
mr carmack - rock dem (maxx baer re-think)
ticklish - abstrakt
ahh ooh - right by night
machinedrum - fantastix
deft - crown point
noh vae - oh man
pl4net dust - quest
sully - helios (philip d kick remix)
alix perez & stray - gully halves
alix perez - u
shades - hpeflex
bone squad - danskhall
halogenix, imanu - technoid
reso - gastroblapz
aeterna - raiku's void
mono/poly - teach you all a lesson
ivy lab - orange
provoke - run it
clothcutter - unbroken
marcus intalex - climbing up the walls
danny scrilla - suede suit
tall timber - mass false memory
tall timber - burger
john frusciante - usbrup pensul
nookie - shining in da darkness
ramos, supreme, & sunset regime - the journey part 1 (fusion remix)