#artist - #tracklist
repeated viewing - vicious and disgusting
antechamber - ossuistone
cervello elettronico vs veldt - your god
timothy j fairplay - ritualistic overtones
kendal - no surrender
euph - stolen
otik - long time no see
pixelord - plank
thys + two fingers - charlatan
lorenzo senni - the power of failing
pixelord - amen
addison groove - brand new drop (nikki nair remix)
loraine jones - marg ft tardast
thelem - akemie's dub
klasey jones - serenity
ennja x numback - travel
apostol - how does it feel?
halfmassed - cantleaveherealone
ic3peak - nramr
gnomus - marcante
evoam jrost = i;tra (yung sherman remix)
sublab - ride to infinity
dj ride - darkskyyy
we rob rave - so hot
stayhigh - don't ya hurt me no more
podij, former - ultra
umanu, icicle - preamble
victim, njin - alien trader
levela - barnacles
collins - vendetta
vector seven - shapeshifter
we are magonia - diabolus in musica
wldv - voices of the stars
midnight danger - to the shadows and back
nickbee, deerhill - ether
annix - caesium
brothel x sidewalks & skeletons - birth
ero (set) - i choose to disappear (hazard remix)
salem - starfall
deadcrow - unity
unhombre solo - solo
the invincible limit - push (new mix)
grimlin - trapped on tape
maelstrom & louisahhh - ascender
forever grey - downpour
korine - cold heart
boy harsher - pain
coil - things happen
burning tapes - labyrinthine