#artist - #track
matti bye - solen
roel funcken - danzar arturion (anthony baldino remix)
rob clouth - clockwork atom
ekman - no more conditional elements
pessimist - rut
overlook & karim maas - chalk
swarm intelligence - plight
luster & bela evers - eternal (ancient methods autumn mix)
tim tama - dream syntax
aqxdm - requiem
vacant - apart
joefarr - spectate
pearson sound - alien mode
lone & kettama - the way you feel
umwelt - starless night
corvad - farcaster
anodyne - before chaos (humanoid remix)
machino - ministerio
hodge - ghosts of akina (rainbow edition)
james shinra - window (plaid remix)
daed - h3fsbf6 (dwaalicht remix)
machine girl - infinite potentiality
laura les - livin my best life
mariah carey - love takes time (dj suzmo remix)
coco bryce - get on up
we rob rave - everyday
galaxian - glasgow to detroit
age coin - no corner, no devil
dead man's chest - haunted dub (ruffneck mix)
dev/null & tim reaper - TDD
silkie - jah man (yazzus jungle remix)
kahn - abettoir (yazzu hardcore remix)
riffz - 2 late 2 run (vip mix)
we rob rave - loveumo
culprate - inside (ekole edition)
skeler - arcadia (heimanu remix)
ruby my dear - dedaism (venetian snares remix)
dj y - speed fever
rtr - reward (om unit remix)
limewax - boltcutters
sinister souls & pythius - ultimatum
switch technique - the task
apzolut feat. mc goatzak - lost
dolphin & the dj producer - these eyes
the satan - kicks up
gancher & ruin - impedance
b-key - sanctuary
stazma the junglechrist - data eater
scattyone - down to you
demented frequency - lord have mercy
loefah - disko rekah (remix)
redline & jumanji - wheel up
seekersinternational - no competition
fxbip - noise dawn
religus order - internal conditions
restive plaggona - phantom bull
neud photo - aether
new frame - initiation
s0s gunver ryberg - flux