#artist - #track
ocean wisdom - tiptronic
breaka - icy grills
chrissy - in paradise (loods remix)
dj bark lee - brighta days
ytho - molly
mind of a dragon - bullacake dub
mind of a dragon - flowers dub
soundbwoy killa - turn off the lights
svizz - mom
glacci - boozt
haggi - be like gee vip
key glock - mr glock
isorin - nucleus
yedgar - you're not alone
dbk - gentleman
addison groove - redeye
stayhigh - hurt me
trigga, chimpo, sam binga - mcr
sam binga - spinners
terrorrythmus - sn4p
we rob rave - choir noir
duke deuce - crunk ain't dead
g jones - pixel
dyzphoria - can't relate
juche - till we fail
pinch & kahn ft. killa army - crossing the line
pholo x kareful - second sword
starkey - technicolor 
d.i.e. - move yo body