#artist - #track
canblaster - clockworks
myd - victoria
brenmar - let me know
instra:mental - when i dip
jacques greene - another girl
123mrk - noname
damu - don't cry in my bed
pixelord - kiwi dream (kastle remix)
maribou state - got me down (jason burns remix)
lunice - i see u (girl unit remix)
djg - rites
high powered boys - udon
crookers - bust em up (ft savage skulls)
riko dan - dem gyal deh
dope cope - it's like that
fire workz - limb by lumb (andy jay & s-tee)
dead peanut - the cook
real 2 real - i like to move it (dope cope)
kill the noise - deal with it
surkin - orbital motorway
distal - angry acid
cosmic revenge - frostbite
magnetic man - anthemic
katy b - broken record (dj fresh remix)
redlight - feel so good
rossi b & luca - turbo island
rustie - city star
rihanna - we found love
avicii - levels (skrillex remix)
joker  feat. jessie ware - the vision
hudson mohawke - thunder bay
uncle murda - warning
doctor p - watch out
emeli sande - heaven (pyramid re-fix)
dj fresh - louder (herve remix)
danny byrd - we can have it all
waka flocka flame - to da max
kanji kinetic - deep down south (sick-it remix)
clicks & whistles - adventuretune
martyparty - hard in da paint
big dope p - trinaz geto trak
das racist - michael jackson
damu - circle traps - fjord (futurwurx reflex)
emynd x m83 x lil wayne x rick ross - my tears are becoming john
h-town - they like it slow (starslinger remix)
the clonious - alter-ego-cate
dj earl - hit da bootz
dj rashad & gant-man - heaven sent
canblaster - thunderdome got crunk
ital tek - pixel haze