#artist - #track
roommate - believe me
peverelist - sun dance
phaeleh - the cold in you
synkro - tribe
hyetal - phoenix (fantastic mr fox remix)
freddy todd - blapdillions
nasty nasty - stacking
krampfhaft - spit thunder
machinedrum - the statue
skream - future funkizm
actraiser - tiger road
tes la rok - turn it up
xxxy - open your eyes
arkist - trapped in tivoli
rye rye feat robin - never will be mine (kill the noise remix)
mochipet - whomp-a-saurus sex
ogonek & cooh - scated of dark (kenogo & balkansky remix)
bassnectar - parade into centuries
doshy - suspiria
joy o - knock knock
nightwave - night bird (unknown to the unknown remix)
baobinga & i.d. - tongue riddim (roska remix)
opiuo - war cod
epcot - cloudskipper
heRobost - lumber party
salva - that girl (pharrell ft snoop dogg)
hybris - lair
seba - future sound
nebula - encounters
the square - why & how
teebee - all i need
level 2 - time to do
tom & jerry - maximum style vol 2 (dj marky & spy remix)
star slinger - baby mama
amazon II - booyaa (open your mind)
hired gun - dem gun mad (pow pow)
l double - little roller vol. 1 (nah ease up mix)
international rude boyz - paragone (remix)
rihanna - rude boy (tc remix)
blue mar ten and inside info - still the one
mute & mako - astral transmissions
diamond eye - temple dub