#artist - #track
luisterwaar - ultra sun
manni dee - fried
fulgeance - glamoure
philthkids - bust it
hypha - phixations
mochipet ft. styles p - lets get high
the clonious - alter-ego-cate
hypha - p-town
elfkowitz - purrfect
tyler the creator - french (toro y moi remix)
src - sex on the beach
clicks & whistles - radiator
kastle - you know that i know you know
jason burns - back 2 you
french horn rebellion - up all night (clubfeet remix)
diplo - one kid (feat. nicki minaj, sleighbells, shm)
canblaster & berou - kapongo dance (big dope p remix)
calvertron - r u ready?
tango & ratty - final conflict
alborosie - kingston town (uproot andy remix)
ooah - the love i need
panty raid - testarossa
the hood internet - moment 4 leonora
neki - tuck ya ice bottle song
edwin van cleef - lisztomania (feat. jane hanley)
dillon francis - brazzers theme
doc adam - bang with me (you don't wanna)
dj poppa - who's that (orion edit)
diplo & dillon francis - que que feat maluca
sabo - patchy moombahton