#artist - #track
Gravediggaz - Graveyard Chamber
Vagina Vangi - Servants of Death
aaimon - Amen
White Car - Spread Spit Slap
Balam acab - Dream Out
Ritualz - Third Eye Sixth Sense
Nika + Rory - I'm Not Going Anywhere
Gatekeeper - Wave Design
College - Gate Number 5
Redial - Deadrising
Teeel - Galilean Moons
Night Gallery - Constant Struggle
Cosmetics - Black Leather Gloves (Cosmetics / Premier Rang remake)
Indian Jewelry - Diamond Things
Crystal Castles feat. Robert Smith - Not in Love (Sane Smith remix)
Tense - Turn It Off (Valis remix)
Fever Ray - Triangle Walks (Rex the Dog remix)
Victrola - Maritime Tatami
Stereo - Somewhere in the Night
Soft Metals - Voices
Gatekeeper - Giza
Ou Est Le Swimming Pool - Jackson's Last Stand
Ritualz - Laguna
White Ring - Suffocation
xwxwxwxwv - Stickweed Houses
Lordana - Rain Rain (Posesion)
Party Trash - Diamond
aaimon - Circle Plus Star Waves Square
Magick Mountain - One for My Ego (Holy Other remix)
Tricky - Hell is Round the Corner
??? - Rreevviivvaall
oOoOO - Seaww
Salem - King Night
Deathface - The Horror
Dialect - Sick of Her
White ring - IXC999
Vektroid - Nobody Here
Yeasayer - The Children
??? - ���
Tense - The Chain
Dead Virgin - Watver
Distance - Fading
Asobi Seksu - Trails (Holy Other remix)
Groundislava - Creeper Shit