#artist - #track
slowdive - souvlaki space station
mr. moods - the long walk
unknown source - frowinging
cibo matto - sugar water
ruby - flippin tha bird (ceasefire remix)
dj cam - no competition
small world - sual tone
tricky - overcome
david holmes - don't die just yet
archive - beatufiful world
boards of canada - aquarius
portishead - strangers
rah zen - amen rah
chrome sparks - marijuana
alias - unseen sights
ohbliv - change 85
bullion - are you the one?
kasabian - running battle
the gaslamp killer - turk mex
mon & cantella - roughead
skylab - kabelski
neutral milk hotel - naomi
prefuse 73 - radio attack
baths - aminals
nightmares on wax - bless my soul
manitoba - kid you'll move mountains
ringo deathstarr - stare at the sun
rob dougan - clubbed to death (kurayamino variation)
my bloody valentine - soon (andrew weatherall mix)
can - vitamin c (u.n.k.l.e. mix)
the stone roses - fools gold
the clash - the magnificent seven
!!! - hello? is this thing on?
erase erata - retreat the most familiar
a number of names - shari vari
sparks - beat the clock
a certain ration - do the du
le tigre - deceptacon (remix)
midnight juggernauts - shadows
metro area - orange alert (dfa mix)
bush tetras - you can't be funky
grauzone - eisbar
jah wobble & invaders of the heart - invaders of the heart (remix)
the rapture - whoo! alright - yeah...uh huh
viagra boys - ain't no thief
digitalism - pogo
gossip - in the way of control (soulwax nite version)
lcd soundsystem - daft punk is playing at my house
esg - erase you (puppy to your side edit)
james chance - contort yourself (august darnell remix)
b52s - dance this mess around
gang of four - damaged goods
bloc party - banquet
diemantle - gypsy woman (remix)
bizarre inc - playng with knives
q bass - dancin people (e type remix)
altern8 - infiltrate 202
opus III - it's a fine day
two little boys - stylophonia (headstrong remix)
massive attack - i against i (pagan edit)
terrorize - feel the rhythm
dj seduction - come on
rachel wallace - tell me why (m&m full vocal mix)
the prodigy - your love
electroset - how does it feel
dj seduction - djs take control
smart e's - sesame's treet (remix)
gordon edge - compnded (edge 1)
druid - takeuthere
yold - bish bosh
dj royal t ^ dj xl - turntable overload
sonz of a loop da loop era - far out
krome & time - manic stampede
cosmo & dibs - up keys
criminal minds - re-baptized by dub
the prodigy - out of space
acen - trip to the moon (part 1)
soundcorp - dream finder
underworld - born slippy (nuxx)
pariah - orpheus
burial - archangel
pascaal - drowning in you
martyn - recon
short stories - let it go
koreless - MTI
julio bashmore - battle for middle you
joy orbison - myph mngo
pholo - cold quartz
girl unit - wut
hyades - amber
gladkill - the way you like
pinkpantheress - where you are ft willow (gastah remix)
bakongo + scuba - over again
leonce - calamity
sepalcure - the one
jacques green - another girl
breaka, frazer ray - phone's ringin
yama - crystal sage
yedgar - don't look back
drowzee - starfish
damu - led
joker - purple city
roaming data - bringphone cartel
sammy virji - daga da
sam binga x redders - just here to bubble
murder he wrote - forever