#artist - #track
tragic figures - IV
forever grey - downpour
the soft moon - become the lies
riki - bose lugen (body mix)
shad shadows - vision
kontravoid - faceless
she past away - durdu dunya
korine heaven's - servant
actors - like suicide
the lords of the new church - dance with me
sixth june - night before
siouxie - christine
christian death - spiritual cramp
the spiritual bat - mosaic
drab majesty - kissing the ground
ecmenesia - desaparecer
ministry - i'm falling
holygram - modern cults (blind delon rmx)
sissy misfit - force fedd
urban heat - have you ever?
pictureplane - post physical
the knife - heartbeats
sidewalks and skeletons - abduction
nine inch nails - closer
glass candy - digital versicolor
second still - sleep
depeche mode - it's no good
rendes-vous - ignorance & cruelty
randolph & mortimer - exclude-divide
sisters of mercy - adrenochrome
sex beat - sex beat
bauhaus - dark entries 
mementut - tronus
flowers & fire - substance
shadowhouse - fall down