#artist - #track
Sorsari - iron sun
real tears - the beauty of a sharpened blade
yedgar & sorsari - mythic
Yedgar - the time has come
pholo - luvin me
ONHELL & fracture - vandals
drowzee - patience
eone - levels (gloomy remix)
flowdan, duke & jones - trenches
mono/poly - technosis
leonce - ventriloquist
raw takes - dogs
overmono - so u kno
prozak - make me feel
opus - sneaky
xander - the energy
hypna - nylon hood
pholo - cold quartz
pagan - like a fool
yoofee - pendulum
cozen - big thighs
0h85 - don't stop
bsn posse - burning shoes
moondoctor x rashad - can you feel it
bennelux - mysterious vibes
posij - harbinger
ivy lab - stacked
kretekboyz - darling
philip d kick - bleach
latesleeper & gyrofield - wake up slap
deft & lewis james - octo
jook - wise
lil boosie ft foxx & webbie - wipe me down