#artist - #track
ava akira - locket (kareful's overdose in the club edit) [@ava_akira, @karefuluk]
riley musician - iced out [@rileythemusician]
hullabalo0 - dancing in the sky [@hullabalo0]
ravenna golden - big knife [@ravennagolden]
circuit hour - new folder (8) (w/ nox, snoii and softspeaker) [@circuithour]
angel cannon - crystalline [@angelcannonmusic]
axl & japano file - broken seal [@japano-file @teneki]
hyleo - synchronize [@hyleo]
youth - club bomb [@moidelabel]
danny l harle & dj danny - on a mountain [@dannylharle]
tommy cash & danny l harle - x-ray (harlecore re-edit) [@iamtommycash]
static angel - close the sky [@static-angel]
altered soul - dysfunctional utopia (boring love) [@thealteredsoul]
100gecs - hand crushed by a mallet (visla edit) [@v_i_s_l_a]
data_haven - utopia [@data_haven]
divine - given my everything [@divine]
sophie - immaterial (tom finster flips result flip) [@tomfinster]
underscores - spoiled little brat [@underscores]
luna lenta - digital memories [@lunalenta]
osias - to the stars [@osiasmusic]
synthion - there for me [@synthion]
assertive - hyperspace [@assertivef]
perfume - flow [@perfume-music]
fromtheheart - big kids [@thefthproject]
madge - ethanol [@madgetunes]
we rob rave - in another world we are dancing together [@werobrave]
alice gas - i h8 u!!!! [@alice-gass]
leroy - we love your vibe [@c0ncernn]
simi - fajny pan jacek [@siminczak]
100gecs - toothless [@100gecs]
danny l harle - take my heart away (yasutaka nakata remix) [@yasutakanakata]
golin - ringo love [@5_lin]
nari, slushh, lowely god, alice gas - kuromi face tat [@xx_lowly_xx]
silou and nerai - feedback [@siloumusic]
jigitz - where do we go? [@boyjiggy]
sublab - chrome castle [@sublabmusic]
gupi x fraxiom - thos moser [@gupimusic @fraxiom]
easyfun - laplander [@easyfun]