#artist - #track
dj ss - black (vip)
fidser - got my bottle
iron man - search & destroy
static angel - pathfinder
doormouse - skelechairs
goreshit - 26arp
bex 2 light - borg
dwaalicht - firmament
moresounds - you don't know 
stazma - data eater
g jones & eprom - final lap
aphex twin - milk man
the satan -psycho
pish posh - corrupt cops (evol intent remix)
gizmode - sincc the crackstep
duran duran duran - hair metal
lockjaw - in my brain
rob gee - ecstacy you got what i need
scooter - how much is the fish
client_03 - hope repeater
benny page - champion sound (serial killaz remix)
dj ss - lighter
sophie - immaterial (tom finster remix)
sully - swandive
remarc - rip
we rob rave - brothers and sisters
aaron spectre - create the future
tusk mite - tetraburst
nasenbluten - intellectual killer 
overcast - problem solver
ice cube & dr dre - natural born killaz
venetian snares - ultraviolent junglist
squarepusher - angstrom-feck 4
smart e's - sesame's treat (dj krome and time remix)
dj seduction - djs take control
sons of a loop da loop era - peace & lovism
bizarre inc - playing with knives