#artist - #track [@soundcloud]
prayer - in your arms [@hooversound]
s. kid - baadboy music [@ppjrecordings]
proc fiskal - mullit madollock [@procfiskal]
sun people - it's yours [@simon-off]
coco bryce - bait hoven [@cocobrycebeats]
anna morgan - turbo moto [@annamorgan_dj]
jon1st - pantone suplex [@jon1st]
arcane - won't deny [@arcane_official_music]
dead man's chest - myth & fire [@eveson]
innercore - ravelation [@teksteppa]
tim reaper - dead and buried [fx remix] [@tim-reaper]
dwarde - something that you feel (VIP)
sully - 5ives [@sullye64]
jonny faith - open my eyes [@jonnyfaith]
bazia - get me high
redline & jumanji - wheel up [@redlinedj]
zar - my rights [@zar34461]
redders & sam binga ft. slay - shelling [@sambingamusic]
dj trax - stronger
duburban - sweeter victory [@duburban-poison]
b-complex - beautiful lies (l-side remix)
sound shifter - mi a champion
yaano - blossom [@yaanodnb]
posij - purple foliage [@posij]
klinical - my number [@klinicaldnb]
the outsiders - volucite [@theoutsidersdnb]
imanu x icicle - preamble [@imanumusic]
aka - wake [@akadnb]
jon tho - no more [@jonthoaudio]
latesleeper & gyrofield - wake up slap [@gyrofieldmusic]
levela - barnacles [@djlevela]
the caracal project - the world stopped [@thecaracalproject]
yoshuu - apparentia [@yoshuumusic]
brain crisis - contrast flight [@brain-crisis]