#artist - #track
sv1 & 0fff1a - glass
otto von schirach & qebrus - ?????
krtm - man with knife
voltra - instruction set
deadcrow - hive mind
baauer - swoopie (rl grime edit)
oolacile - hople555
micromakine - grip design (fracture 4's seeds of doube remix)
oona dahl - walt lifted (sensenet remix)
diemantle - wait for the drop
limewax - jungled vibes
smog - surfactant
masayoshi limori - realm
dimension - offender
montell2099 + rl grime - rusynth
fate - haunted
drumcorps - hell yeahhh
igorrr -very noise
drumcorps - human nature
dawl - let's go
will hofbauer - caned
warwick - ruff
eone & mere formaily - shell disposal unit
m!ngo - outcast
mandidextrous - the fight to vienna (boxxi mix)
and - angar 51
nuushi icarus
sanjaux - venture
niteboi - breakrules
ava akira and kareful - locket (overdose in the club edit)
folie - ragoon
kelis - milkshake (harka bootleg)
kessler - lambert rise
doc scott - the unofficial ghost
dimension - altar
bad company - the nine 
otto von schirach & qebrus - ????