#artist - #track
ben frost - peter venkman pt.1
olekranon - bubonic
datacode - 侵入 (intrusion)
aldrich - dead2me
alberich - no reference to the absense of allegory
consulate - beveryly anschluss
aemit - hunter
bipol - in the name of the workers
hide - bound/severed
cindytalk - the labyrinch of the straight line
naked - unity
roly porter - in flight
swarm intelligence - courtyard
emptyset - plane
hex - open source
qebrus - *********
qebrus - ѻѲѻӨѻ三¬=≡¦≡=¬三ѻӨѻѲѻ
otto von schirach and qebrus - 𝔉𝔞𝔱𝔞 ℭ𝔩𝔞𝔯𝔞 𝔐𝔬𝔯𝔤𝔞𝔫𝔞 𝔅𝔦𝔰𝔪𝔲𝔱𝔥
cytos & takeshi muto - aventura
tekeshi muto & tomoroh hidari - vienna mood tits touched
phoenecia - odd job (rhythm box version by soul oddity)
death grips - gillotine (subjex remix)
spit mask - tighten up
front line assembly - body count
mr gasmask & acidolido - 9'o clock driller
venetian snares - she married a chess computer in the end
belief defect - disembarking horizons
violator - not here
nine inch nails - help me i am in hell