#artist - #track 
old nick - you can't unplug the hanted landline
enjoii - teardrop w/ brothel ft luna mono
overlook - ultra violence
shiken hanzo - shinobi hiden
goreshit - ligwiybd
mask - square off (roni size remix)
zuli - tany
kray - overflow
we rob rave - ravers nature
holly - labyrinth
deft & lewis james - octo
a. fruit - please, arrive
mimideath - calcium
zora jones - sister's bride
gps tony - pig sweat
we rob rave - gabbermentasm
snappy jit & jammin joe - beast mode (hype mix)
innercore project - terminal velocity
baauer - swoopin (rl grime)
slikback - lauka
hitori tori - night howl
slikback - worth
synalegg - engineer
heimanu - worlds
dollywood1 thislandis wubz - holding back
halber ball - rift 3
om unit - treading earth
sam interface - shadows
pholo - glue
krane + neon sound - startup
krane + maazel - lullaby
m!ngo - outcast
commodo - guah
circa - hp up
private caller - thuggish ruggish
carpainter - time of rage
zeds dead, deathpact - ether (eprom old school remix)
logos & mumdance - chaos engine
bone head - sortie
anz - unravel in the designated zone
tristan arp - unfurling
liebkecht - voula
l.f.t. - kein angst
the soft moon - without (codex empire remix)
old nick - tears shed over a medieval grave

