#artist - #track
Little Snake - In My Head
Henry Greenleaf - Pan Strings
Doggy - Psyche (Alternate mix)
Rhyval - &#^!++ Hassle
Sam Binga x Fox x DJ Polo - Weh Mi Seh
Breaka x Frazer Ray - Phon's Ringin
MPH - Deja Vu
Exium - Low-Pressure Discharge
LSDXOXO - Baby
True Peak Limit - Posting
Eomac - Seashells
Joe Koshin - Storm Dub
Nicolas Duque - Bristol Love (Holloway Remix)
Big Dope P - Tounsi Tek
Commodo - Scabz
Strange Arrival - Calabi-Yau Manifold
Commodo - Guah
Eone x Time94 - You and Me
Legion - We are Many
Exaltics & Paris the Black FU - We Exist
Joe Koshin - There's Nothing
Hornsey Hardcore - Don't Get Strange
Burial - Chemz
Somatic Responses - Return to Abnormal
Zadig - Circular Causality
Pixelord - NFT Acid
Aura T-09 feat Bootee - In Dreams
Unglued - h to the a to the r to the d to the c to the o to the r to the e
Von Riu - Smashed Up
Big Dop P feat DJ Jayhood - RDT
Same O - Pick Ur Side
Driss Bennis & Swoze - Them From the Scam Planet
Sun People - Rich Man Poor Man
Dead Man's Chest - Myth & Fire
Sam Binga & Addison Groove - Drop That Pop That (Hyroglifics rmx)
Proc Fiskal - Mullit Madollock
Fracture ft. Lucie La Mode - Some Love
Pixelord - Tron
Kiddy.wav - Supahotfaya
W00dy - They Have 4 Subs
Ornette Hawkins - Return to Never
Sun People - Spirits
Calculon & Root For the Villain - Collusion (VIP)
Karim Maas - Dimensions
Ars Dada - Doden
S. Kid - Original Ninja
Jonny Faith - Open My Eyes
Keeno - I Wonder (whiney Remix)
B-Complex - Beautiful Lies (L-Side remix)
SPY - Bad Monday
RDG ft. Homemade Weapons - Heshar
QZB x Rider Shafique - Perfectly Aligned
Response - Betrayal
Visages - Gymnopedies
Sonic - Piano Anthem (Spy remix)
Sinister Souls - Judge
Lurk x Delmark O - From The Dust
Diplomat - Brainwave
Deathmachine - Out of Statis
Koan Sound - Chronos
The Bug - Take
####Title|Live Session #43
####Audio|https://soundcloud.com/cutups/cutups-live-session-43