#artist - #track
{arsonist} - kaypartyte
kessler - moonlight branches
san - half in 
dbridge - norm
asc - anomaly
dried leaves - sea foam
aka - unity
seba - can't describe
the untouchables - tell dem
the untouchables - black tears
out of fuel - cabin fever
torn, roho - proelli
ink, loxy, genotype - yellow eyed demon
kessler - lambert rise
marcus jr - another world
tmsv - smarter than u
sun people - all good
tim reaper - ninja rope dub
es.tereo - ultimas breath
nu partial - cross your mind
acrone - hope dies last
aleph - moment
brendan rincon - variations
207 - pressure force
acre + filter dread - flash speed
actraiser - terranigma
afta-1 - the time in between
appleblim + peverelist - circling
2562 - channel one
2562 - redux
207 - rudeboy sound
andy stott - droppin
arkist - fill my coffin
author - drain
badawi & machinedrum - no schnitzel
bakey - yeh
baobinga & id - tongue riddim (roska remix - bing's refix)
bar 9 - one
benga - i come from london
skream - shake it
skream - tek-a-pill
gatekeeper - let us in
geiom - osceola
hyetal - searchlight
ikonika - please
ghast - treatment
jaswan - quantum cryptography