#artist - #track
bombardier - sickness - dyslexic response
cassandra datakill - discussion - eupholus
hecate - trial of gille de rais pt2 - zod 2
slepcy - repeat - koolpop
atrax morgue - case history #10 - self abuse
pthalocyanine - u know the score (scud remix) - klangkreig 1
rotator - enemy... - damage 1
noize punishment - i remember it...clearly - hardliner
parasite - freak stepper - peace off ltd
doormouse - a million more - addict 5
the syncopated elevators legacy - vincenzo's grammatical cumshot - ambivilence lens
ryko - hype - protokole
bambule - tripped wire (photon emissions remix) - praxis
somatic responces - alpha augmentation (t1x remix) - hymen 30
hecate - agrippa - zhark lp
abelcain - aguirre: der zorn gottes - lowres5
somatic responces - automata (hardway) - hymen30
synapscape - bizarre vinyl junky - antzen
imminent starvation - hypsen - hymen6
minion - ... - eupholus 4
curtis chip - it starts with a - zod
d'arcangelo - goodbye l (andre esterman mix) - orange
while - slip - chocolate industries
squarepusher - red hot car - warp
drazen - ancient future - balkan radar
joseph nothing - ballad for the unloved - planet mu
wagon christ - king's lyn - ninja tune
soundmurderer - bad sound - rewind
venetian snares - clearance bin - history of the future