#artist - #track
cobra dukes - leave the light on (knightlife remix)
bloody beetroots - i love the bloody beetroots
altern-8 - armageddon
edwin van cleef - all i think about is you
black box - strike it up
miami horror - holidays (lenno & jesse oliver remix)
hail social - heaven (designer drugs mix)
one-two - o-hot brain (filthy dukes society remix
allmostt - hairdresser
123mrk - weird (kastle remix)
jason burns - see thru you
rihanna - pour it up (rl grime remix)
minnesota - tokyo
mrk1 - download the world
big boi - shoes for running
sleigh bells - demons (diplo remix)
eprom - evil shit
heRobust - og status
moondoctor & fresh till def - who got shot
pixelord - footpork
three 6 mafia - who run it
heRobust - thang is jumpin
lockah - please lockah, don't hurt em
danny byrd - we can have it all
origin unknown - valley of the shadows
504 boyz - i can tell (remix)
aquadrop - hood
beatslave - fly up (accordion swagger)
dj chap - diso stew
dj chap - super rich kids
kanye west - mercy (rl grime & salva remix)
krampfhaft - twin prime
asap rocky - fashion killa (druid cloak moonglade remix)
my dick - dancing in my dick
crookers - bust em up (slick shoota remix)
big sean & nicki minaj - dance (a$$) remix
mc hammer - u can't touch this
psychotropic - hypnosis (sl2 remix)
la bouche - sweet dreams
culture beat - mr. vain
joker - old era
silversun pickups - lazy eye (curtis vodka edit)
timbaland - miscommunication (the bloody beetroots remix)
the fugees - ready or not (drop the lime slime you refix)
thunderheist - suenos dulces
philadelphyinz - pittsburgh club anthem
dre skull - i want you back
future - same damn time (busted by herobust)
mydick - dick dreams
girl talk - make me wanna
tag team - whoomp there it is
the prodigy - everybody in the place (fairground remix)
scatman john - scatman
emynd - reach out
modest mouse - float on (teenwolf bmore remix)
tegan & sara - back in your head (tyler fredchuk's 1/2 alive disco remix)
dj class & lil jon - i'm the ish remix
tittsworth - drunk as fuck (meterhead remix)
intoxicated - burn it down (hatchmatik's burn down the club remix)
crime mob - stilettos (pumps)
the house crew - we are hardcore
