#artist - #track
123mrk - pleasure (obey city remix)
radian - sunset
arkist - rndezvous
sango - owe me (ta-ku refix)
trinidad james - gold on my mac book (lakim refix)
jaw jam - long night
sophie - bipp
ghosts on tape - video void
maelstrom - bipolar
salva - bbq
xxxy - ordinary things
wikek - totem
muscles - one inch badge pin (bag raiders remix
midnight juggernauts - twenty thousand leagues
the cribs - men's needs (css remix)
computer club - bizarre love triangle
two door cinema club - something good can work (the twelves remix)
futurecop - fast forward 1-2 step mashup
lockah x taste tester - u don't know me
salva - get a life
clicks & whistles - cackalackin
major lazer - mashup the dance (feat partysquad)
joker - my trance girl
missy elliot - work it (r4 remix)
sir mix a lot - baby got back
justin timberlake - like i love you (lakim reup)
halp - bablinggg
ta-ku - clik clak
aaliyah - r u that somebody (brenmar windy city mix)
ludacris - if i ain't fucked up
aquadrop - trip trap
eptic - bust em out (mrk1 remix)
bro safari & ufo - animal
boaz van de beatz - flontie stacks pt 2
yellow claw - allermooiste freestje
jill scott & bun b - so gone (shoyofootwork remix)
paisley parks - walkin down da street
dj fresh & diplo - earthquake (feat dominique young unique)
steph, mr polska & leo - flitsend
major lazer - get free (yellow claw get free money remix)
mr polska - technologee
the clipse - grindin
chvrches - recover (cid rim remix)
taz & akka - paul is dead
mr polska - reef teef
chrissy murderboy - slang it
krampfhaft - twin prime
cali swag district - teach me how to dougie
die antwoord - wat pomp
ooah - crunk down where ya at
pickster & riot earp - ratchet gas
hudson mohawke - thunder bay
ace hood - bugatti (valid trap remix)
boaz van de beatz - breakoe
lil boosie ft. fox & webbie - wipe me down
