#artist - #track
druid cloak - blue fame (shackles remix)
nangdo - c'mon
yellow claw - kaolo
twrk - living room (tielsie remix)
raumskaya - make haste
blck lite - neighbors gon hear us
calibre - don't want your love
xlii - no cure (ean remix)
fresh til def x moondoctor - gimme the sign
taal mala - do it
the dream team - stamina
boylan - super 6 one
lemon d - this is la
dj rashad - lickin & kickin'
shy fx - bambaataa
umbertron - london gold
om unit - vibrations (machinedrum remix)
moondoctor & fresh til def - who got shot?
remarc - in da hood
unknown - love & affection
rihanna - pour it up (rl grime remix)
enei - i don't know
total science - melody snow
chvrches - recover (cid rim remix)
benny page - number one
major lazer - jah no partial feat flux pavillion (run dmt remix)
brisk & trixxy - eyeopener
mr. carmack - birth control
leftside x T.I. - bubble (ball riddim) (dubbel dutch remix)
pixelord - cycloferon
dj snake - bird machine